id,star_rating,room_type_id,,
1,5,1,,
2,5,1,,
3,4,1,,
4,4,1,,
5,5,1,,
6,1,2,,
7,2,2,,
8,3,2,,
9,4,2,,
10,5,2,,
11,3,3,,
12,2,3,,
13,1,3,,
14,2,3,,
15,3,3,,
16,4,3,,
17,5,3,,
18,5,4,,
19,4,4,,
20,3,4,,
21,4,4,,
22,3,4,,
23,2,4,,
24,1,5,,
25,2,5,,
26,3,5,,
27,3,5,,
28,3,5,,
29,4,5,,
30,5,6,,
31,5,6,,
32,4,6,,
33,4,6,,
34,5,6,,
35,5,6,,
